╔═════════════════════════════════╗        ╔═════════════════════════════════╗
║.................................║        ║.................................║
║.................................║        ║.................................║
║.................................║        ║.................................║
║.................................║        ║.................................║
║.................................╬XXXXXXXX╬.................................║
║.................................║        ║.................................║
║.................................║        ║.................................║
║.................................║        ║.................................║
║.................................║        ║.................................║
║.................................║        ║.................................║
╚═════════════════════════════════╝        ╚═════════════════════════════════╝