╔═════════════════════════════════╗        ╔═════════════════════════════════╗
║.................................║        ║.................................║
║.................................║        ║.................................║
║.................................║        ║.................................║
║.................................║        ║.................................║
║.................................╬xxxxxxxx╬.................................║
║.................................║        ║.................................║
║.................................║        ║.................................║
║.................................║        ║.................................║
║.................................║        ║.................................║
║.................................║        ║.................................║
╚═════════════════════════════════╝        ╚═════════════════════════════════╝