╔═════════════════╗                
║.................║                
║.................║                
║.................║                
║.................╚════╗    ╔═════╗
║......................║    ║.....║
║......................╬XXXX╬.....║
╚══════════════════════╝    ║.....║
                            ╚═════╝