╔-----------------╗                
║.................║                
║.................║                
║.................║                
║.................║----╗    ------╗
║......................║    ║.....║
║......................╬XXXX╬.....║
------------------------    ║.....║
                            -------