╔═════════════════╗                
║.................║                
║.................║                
║.................║                
║.................╚════╗    ╔═════╗
║......................║    ║.....║
║......................╬XXXX╬.....║
╚══════════╬═══════════╝    ║.....║
           X                ╚═════╝
           X
           X
           X
       ╔═══╬═════╗
       ║.........║
       ║.........║
       ║.........║
       ╚═════════╝