╔═════════════════════════════════╗
║.................................║
║.................................║
║.................................║
║.................................║
║.................................║
║.................................║
║.................................║
║.................................║
║.................................║
║.................................║
╚═════════════════════════════════╝